#########################
#o.....{...............o#
#.######.........######.#
 .#    #.### ###.#    #. 
 .#    #.# M   #.#    #. 
#.######.#######.######.#
#o...........MM......M.o#
#########################
